111101111101111111101111001111
111101111101111111101111001111
111101111101111111101111001111
111101111101111111101111001111
111101111101111111101111001111
111101111101111111101111001111
111101111101111111101111001111
111101111101111111101111001111
111101111101111111101111000000
111101111101111111101111000000
111101111101111111101111000001
111101111101111111101111000001
111101111101111111101111001111
111101111101111111101111001111
111101111101111111101111001111
111101111101111111101111001111
111101111101111111101111001111
111101111101111111101111001111
111101111101111111101111001111
111101111101111111101111001111
111101111101111111101111001111
111101111101111111101111001111
111101111101111111101111001111
111101111101111111101111001111
111101111101111111101111001111
111101111101111111101111001111
111101111101111111101111001111
111101111101111111101111001111
111101111101111111101111001111
111101111101111111101111001111
111101111101111111101111001111
111101111101111111101111001111
111101111101111111101111001111
111101111101111111101111001111
111101111101111111101111001111
000000000000000000000000000000
000000000000000000000000000000

