111101111101111111101111001111
111101111101111111101111001111
111101111101111111101111001111
111101111101111111101111001111
111101111101111111101111001111
111101111101111111101111001111
111101111101111111101111001111
111101111101111111101111001111
111101111101111111101111000000
111101111101111111101111000000
111101111101111111101111000001
111101111101111111101111000001
111101111101111111101111001111
111101111101111111101111001111
111101111101111111101111001111
111101111101111111101111001111
111101111101111111101111001111
111101111101111111101111001111
111101111101111111101111001111
111101111101111111101111001110
111101111101111111101111001111
111101111101111111101111001111
111101111101111111101111001111
111101111101111111101111001111
111101111101111111101111001111
111101111101111111101111001111
111101111101111111101111001111
111101111101111111101111001111
111101111101111111101111001110
111101111101111111101111001111
111101111101111111101144002233
111101111101111111101144002233
111101111101111111101444002233
111101111101111111101144002233
000000000000011110000000000000
000000000000015510000000000000
000000000000015510000000000000

