00000033000000330000000000
00000033000000330000000000
00110033000000110011001100
00110033000000110011001100
00110000000011110011331100
00110000000011110011331100
00000011000000000033000000
00000011000000000033000000
44000011000033000011441133
44000011000033000011441133
44440000001100003300440000
44440000001100003300440000
00111111444444330000441100
00111111444444330000441100
00000033441100110011001100
00000033441100110011001100
33110033001100110000001100
33110033001100110000001100
00110011001111110011331100
00110011001111110011331100
00110011001111110000000000
00110011001111110000000000
00110000000000000011001100
00110000000111100011001100
00110011000155100011111100
00110011000155100011111100