00000000000000000000000000
00000000000000000000000000
00110011001100110011001100
00110011001100110011001100
00110011001100110011001100
00110011001100110011001100
00110011001100110011001100
00110011001133110011001100
00110011001133110011001100
00110011001100110011001100
00110011000000000011001100
00110011000000000011001100
00000000001100110000000000
00000000001100110000000000
00000111100000000011110000
33000111100000000011110033
00000000001100110000000000
00110011001111110011001100
00110011001111110011001100
00110011001100110011001100
00110011001100110011001100
00110011001100110011001100
00110011000000000011001100
00000000000111100000000000
00000000000155100000000000
00000000000155100000000000